00000000000000000000
00111111111111111100
01122222222222222110
01112233333322222110
01112234443333222210
01122333443333222210
01122233333333321110
00112222222222222110
00011111111111111100
00000000000000000000